SSSSSSSSSSSSSSSSSSSSSSSSSS
SSSSSSSSSSSSSSSSSSSSSSSSSS
SSWWSSWWSSWWSSWWSSWWSSWWSS
SSWWSSWWSSWWSSWWSSWWSSWWSS
SSWWSSWWSSWWSSWWSSWWSSWWSS
SSWWSSWWSSWWSSWWSSWWSSWWSS
SSWWSSWWSSWWAAWWSSWWSSWWSS
SSWWSSWWSSWWAAWWSSWWSSWWSS
SSWWSSWWSSWWSSWWSSWWSSWWSS
SSWWSSWWSSSSSSSSSSWWSSWWSS
SSWWSSWWSSSSSSSSSSWWSSWWSS
SSSSSSSSSSWWSSWWSSSSSSSSSS
SSSSSSSSSSWWSSWWSSSSSSSSSS
WWSSWWWWSSSSSSSSSSWWWWSSWW
AASSWWWWSSSSSSSSSSWWWWSSAA
SSSSSSSSSSWWSSWWSSSSSSSSSS
SSSSSSSSSSWWWWWWSSSSSSSSSS
SSWWSSWWSSWWWWWWSSWWSSWWSS
SSWWSSWWSSWWSSWWSSWWSSWWSS
SSWWSSWWSSWWSSWWSSWWSSWWSS
SSWWSSWWSSWWSSWWSSWWSSWWSS
SSWWSSWWSSSSSSSSSSWWSSWWSS
SSWWSSWWSSSSSSSSSSWWSSWWSS
SSWWSSWWSSSWWWWSSSWWSSWWSS
SSSSSSSSSSSWSSWSSSSSSSSSSS
SSSSSSSSSSSWSSWSSSSSSSSSSS
